FFFFFFFFFFFFFFFFFFFFFFFFFFFFFFFFFFFFFF
FFFFFFFFFFFFMMMMMMMFFFFFFFFFFFFFFFFFFF
FFFFFFFFFFFMMMMMMMMMMMMMMMFFFFFFFFFFFF
FFFFFFFFFFFMMMMMMMMMMMMMMMFFFFFFFFFFFF
FFFFFFFFFFFMMMMMMMMMMMMMMMMMMFFFFFFFFF
FFFFFFFFFFFFMMMMMMMFFFFFFFFFFFFFFFFFFF
FFFFFFFFFFFFFMMFFFFFFFFFFFFFFFFFFFFFFF
FFFFFFFFFFFFFMMFFFFFFFFFFFFFFFFFFFFFFF